#####################
#@..................#
#...................#
#...................#
#...................#
#...................#
#...................#
#...................#
#...................#
#...................#
#...................#
#...................#
#...................#
#...................#
#..................%#
#####################