#####################
#@........#.........#
#.........#.........#
#.........#.........#
#.........#.........#
#.......#####.......#
#.......#####.......#
#..................%#
#.......#####.......#
#.......#####.......#
#.........#.........#
#.........#.........#
#.........#.........#
#.........#.........#
#.........#.........#
#####################
