#####################
#@#...#.............#
#.#.#.#.###########.#
#%#.#.#.#.........#.#
#.#.#.#.#########.#.#
#.#.#.#.#.......#.#.#
#.#.#.#.#.#####.#.#.#
#...#.#.#.....#.#.#.#
#####.#.#####.#.#.#.#
#.....#.......#.#.#.#
#.#############.#.#.#
#.#...#...#...#.#.#.#
#.#...#.#.#.#.#.#.#.#
#.#####.#.#.#.#.#.#.#
#.......#...#...#.#.#
#####################