#####################
#@#...#.............#
#.#.#.#.###########.#
#.#.#.#.#.........#.#
#.#.#.#.#########.#.#
#.#.#.#.#.......#.#.#
#.#.#.#.#.#####.#.#.#
#...#.#.#.....#.#.#.#
#####.#.#####.#.#.#.#
#.....#.......#.#.#.#
#.#############.#.#.#
#.#...#...#...#.#.#.#
#.#...#.#.#.#.#.#.#.#
#.#####.#.#.#.#.#.#.#
#.......#...#...#.#%#
#####################