#####################
#.........@.........#
#...#############...#
#...................#
#########...#########
#...................#
#...#############...#
#####################
#####################
#.........@.........#
#...#############...#
#...................#
#########...#########
#...................#
#...######%######...#
#####################