#####################
#@.................%#
#...................#
#...................#
#...................#
#...................#
#...................#
#...................#
#...................#
#...................#
#...................#
#...................#
#...................#
#...................#
#...................#
#####################