#####################
#@..#.......#.......#
#...#.......#..###..#
#...#...#...#..#....#
#...#...#...#..#....#
#.......#......######
#.......#...........#
#####################
#####################
#...........#.......#
######......#.......#
#...%#..#...#...#...#
#....#..#...#...#...#
#..###..#.......#...#
#.......#.......#..&#
#####################