#####################
#@.....*#.../......%#
#.........../.......#
#.........../.......#
#.........../.......#
#.........../.......#
#.........../.......#
#####################
#####################
#@...../............#
#....../............#
#....../............#
#....../............#
#....../............#
#....../....*#......#
#####################