#######2#############
#@...........1*.....#
#...................#
#...................#
#...................#
#####################
#........*0.........#
#...................#
#..................&#
#...................#
##################3##
#.............//....#
#.........@...//...%#
#.............//....#
#.........#...//....#
#####################